                    F                                 255,162,0
           
           
           
                            WE                        ./textures/west.xpm
           
           
                                EA                           ./textures/east.xpm
                            C               21,62,230
           
                                      SO                            ./textures/south.xpm
           
                NO                 ./textures/north.xpm
           

11111111111111111111
10001000000000000001
10001111000000000001
1000000100N000000001
10000001000000000001
10000001000000000001
10001000000000000001
10000000000000000001
11111111111111111111


