                      F 32,128,64

NO ./textures/north.xpm



EA                        ./textures/east.xpm


WE                     ./textures/west.xpm

C                                                     64,128,192

SO                     ./textures/south.xpm


11111111
10N00001
11111111






