                      F 32,128,64

NO ./textures/north.xpm



EA                        ./textures/east.xpm


WE                     ./textures/west.xpm

C                                                     64,128,192

SO                     ./textures/south.xpm


11111111111111111111111111111111
10000000001100000000000011111111
10110000011100000000000011111111
100100000000000000000000111111111
111111111011000001110000000000001
100000000011000001110111111111111
11100011111111011100000010001
11100011111111011101010010001
11000000110101011100000010001
10000000000000001100000000001
1000N000000000001101010010001
1100000111011101111101111000011
11110111111101011101111010001
11111111111111111111111111111







