



SO                     ./textures/south.xpm

EA                        ./textures/east.xpm

WE                     ./textures/west.xpm

C 64,128,192
F 32,128,64


1111
10N1
1111