NO ./textures/north.xpm
SO ./textures/south.xpm
WE ./textures/west.xpm
EA ./textures/east.xpm

CA 255,0,0
CF 250,1,3

11111111
10000001
100N0001
10000001
11111111