WE ./textures/west.xpm       
EA ./textures/east.xpm
SO ./textures/south.xpm
NO ./textures/north.xpm

C 42,12,31
F 123,72,99
   
        1111111111111111111111111
        1000000000110000000000001
        1011000001110000000000001
        1001000000000000000000001
111111111011000001110000000000001
100000000011000001110111111111111
11100011111111011100000010001
11100011111111011101010010001
11000000110101011100000010001
10000000000000001100000000001
1000N000000000001101010010001
1100000111011101 11101111000011
11110111 1110101 101111010001
11111111 1111111 111111111111


