C  255,255,255
F 255,255,255

NO ./textures/north.xpm
SO ./textures/south.xpm
EA ./textures/east.xpm
WE ./textures/west.xpm

  1111
1111
10N1
1111
