NO ./textures/ryan0.xpm
SO ./textures/ryan1.xpm
WE ./textures/ryan2.xpm
EA ./textures/ryan3.xpm

F 0,0,0
C 0,0,0

111111111111111111111111111111111111111111111111
100000000000000000000000000000000000000000000001
101111111111111111111111111111111111111111110101
101000000000000000000000000000000000000000000101
101010101010101010101010101010101010101010101101
101010101010101010101010101010101010101010101101
101000000000000000000000000000000000000000000001
101011111111111111111111111111111111111111111101
101010000000000000000000000000000000000000000101
101010011111111111111111111111111111111111101101
101000010000000000000000000000000000000000001001
101011110000000000000000000000000000000001011101
101000000000000000000000000000000000000001000101
1011101111111111111111111111111111111111D1111101
1000000000000000000000000000000000000000000001N1
111111111111111111111111111111111111111111111111