           
                NO                 ./textures/north.xpm
           
           
                            WE                        ./textures/west.xpm
           
           
           
                                      SO                            ./textures/south.xpm
           
           
                                EA                           ./textures/east.xpm

           
F 0,32,0
C 120,0,16

 1111111        111111111
110000011      10000000001
100000001     1000000000001
 1000001     100000000000001
  11011      10000001D1000001
   101        1000001010000001
   101         100001D100000001
   101111111111100001010000001
   10000000000000000111000001
   1011111111111000000000001
   101         100000000001
   101        100000000001
  11011      100000000001
 1000001     1000000N0001
100000001     10000000001
110000011      1000000001
 1111111        111111111
