           
                NO                 ./textures/north.xpm
           
           
                            WE                        ./textures/west.xpm
           
           
           
                                      SO                            ./textures/south.xpm
           
           
                                EA                           ./textures/east.xpm

           
F 21,2100,21
C 64,128,12

11     
1
11111111111111111111111111111111111
100000000010000000000000000000000001 
100000000010000000000000000000000001  1
1000000111000000000000000000000000001
1000E0000000000000000000000000000001    
10000001110000000000000000000000001
100000000000000000000000000000000001
100000000000000000000000000000000001
111111111111111111111111111111111111
11111111111							1
1000000001							1
1111111111							1
