           
                NO                 ./textures/north.xpm
           
           
                            WE                        ./textures/west.xpm
           
           
           
                                      SO                            ./textures/south.xpm
           
           
                                EA                           ./textures/east.xpm

           
C 65,240,255
F 71,19,0000021
11     
1
11111111111111111111111111111111111
100000000010000000000000000000000001 
1000000000100000000000000000000000011  1
10000001111100000000000000000000000001
1000E00D0D0D00000000000000000000000001    
10000001111100000000000000000000001111
100000000000000000000000000000000001
100000000000000000000000000000000001
111111111111111111111111111111111111
11111111111							1
10000000011							1
11111111111							1
