           
                NO                 ./textures/north.xpm
           
           
                            WE                        ./textures/west.xpm
           
           
           
                                      SO                            ./textures/south.xpm
           
           
                                EA                           ./textures/east.xpm

           
F 102,102,255
C 255,153,110

11111111111
10011100001
1N0D0D00001
10011110001
11111111111
