           
                NO                 ./textures/north.xpm
           
           
                            WE                        ./textures/west.xpm
           
           
           
                                      SO                            ./textures/south.xpm
           
           
                                EA                           ./textures/east.xpm

           
                            C               21,62,230
           
           
                    F                                 255,162,0

11111111111111111111
10000000000000000001
10000000000000000001
1000000000N000000001
10000000000000000001
10000000000000000001
10001000000000000001
10000000000000000001
11111111111111111111


