           
                NO                 ./textures/north.xpm
           
           
                            WE                        ./textures/west.xpm
           
           
           
                                      SO                            ./textures/south.xpm
           
           
                                EA                           ./textures/east.xpm

           
                            C               255,0,0
           
           
                    F                                 250,1,3

111111111111111111111111111111111
100000000011000000000000111111111
101100000111000000000000111111111
100100000000000000000000111111111
111111111011000001110000000000001
100000000011000001110111111111111
111000111111110111000000100011111
111000111111110111010100100011111
110000001101010111000000100011111
100000000000000011000000000011111
1000S0000000000011010100100011111
110000011101110111101111000011111
111101111110101101111010001111111
111111111111111111111111111111111


