           
                NO                 ./textures/north.xpm
           
           
           
           
           
                                      SO                            ./textures/south.xpm
           
           
                                EA                           ./textures/east.xpm

           
C 64,128,192
F 32,128,64

        1111111111111111111111111
        1000000000110000000000001
        1011000001110000000000001
        1001000000000000000000001
111111111011000001110000000000001
100000000011000001110111111111111
11100011111111011100000010001
11100011111111011101010010001
11000000110101011100000010001
10000000000000001100000000001
10000000000000001101010010001
11000111011S1111101111000011
11110111111101011101111010001
11111111111111111111111111111

